##########
#........#
#....#...#
#...C#...#
#....#...#
#.....F..#
#........#
##########