##########
#C.#.....#
#..#.###.#
##.#.#...#
#..#.#..##
#.##..#.##
#.....#.F#
##########